8
# # # # # # # #
# . . # . . . #
# r . . . . . #
# . . . . . . #
# # # # R # # #
# # # # # # # #
# # # # # # # #
# # # # # # # #