12
# # # # # # # # # # # #
# # # . . . . . . # # #
# # . . # . B # . . # # 
# . . # . R . . # . . # 
# . . . . # . . # # . # 
# r # . # # . . . # b #
# . . . # . . . . . . # 
# # # # # # # # # # # # 
# # # # # # # # # # # # 
# # # # # # # # # # # # 
# # # # # # # # # # # # 
# # # # # # # # # # # #