11
# # # # # # # # # # #
# # r . . # # # # # #
# . . . . # # B . # # 
# . . . . . . . . # #
# . . . # # # . . R #
# . . . . . . . . # #
# # b . # # # # # # #
# # # # # # # # # # #
# # # # # # # # # # #
# # # # # # # # # # #
# # # # # # # # # # #