12
# # # # # # # # # # # # 
# # Y # # # # # # # # # 
# . . . # # # # # # # # 
# # # . # # # # # # # # 
# b . . y # # # # # # # 
# # . . . . . # # # # # 
# r . # R . c # # # # # 
# # # # . # # # # # # # 
# # # # . B . # # # # # 
# # # # . . . # # # # # 
# # # # # C # # # # # # 
# # # # # # # # # # # #