9
# # # # # # # # #
# # # # r Y # # #
# B p b . . . . #
# . cP # R . # yC #
# # # # # # # # #
# # # # # # # # #
# # # # # # # # #
# # # # # # # # #
# # # # # # # # #