12
# # # # # # # # # # # # 
# # # # # # # # # . P #
# W C Y # # # # . . . # 
# c . . . p y r . . . #
# # # # # # # # # # # # 
# # # # # # # # # # # # 
# # # # # # # # # # # # 
# # # # # # # # # # # # 
# # # # # # # # # # # # 
# # # # # # # # # # # # 
# # # # # # # # # # # #
# # # # # # # # # # # #