10
# # # # # # # # # #
# # # . . . . . . # 
# # # . . R . . # # 
# # . . . . # r # # 
# . . . # . . . # #
# . . . . . . . . #
# . # . . . . . . #
# . . . . . . # # #
# # # # # # # # # #
# # # # # # # # # #