11
# # # # # # # # # # # 
# # # . . . # # # # # 
# . # . . B # # # # # 
# . # b . y . # R . # 
# . # # . # # # . . # 
# . . . . . . . . # #
# . . # rY . . . # # #
# # # # # # # # # # # 
# # # # # # # # # # # 
# # # # # # # # # # # 
# # # # # # # # # # #