8
# # # # # # # # 
# . . # . . . #
. . . b r . . #
# . B . . . # #
# R . . . . # # 
# # # . # # # # 
# # # . # # # # 
# # # . # # # #