9
# # # # # # # # # 
# R . . . # # # # 
# . . B . . # # # 
# . . . . . b r # 
# # # # # # # # # 
# # # # # # # # # 
# # # # # # # # # 
# # # # # # # # # 
# # # # # # # # #