11
# # # # # # # # # # #
# y r b g . . . . . .
# . . . . . Y . . . .
# # . . . G . . . . .
. # . . B . # # # # #
. # . R . . # . . . .
. # # # # # # . . . .
. # # # # # # . . . .
. # # # # # # . . . .
. # # # # # # . . . .
. # # # # # # . . . .